**********
*P       *
*        *
*  M     *
*        *
*     ***
*      M *
*        *
*      G *
**********